NO textures/simonkraft/wet_sponge.xpm
SO textures/simonkraft/wet_sponge.xpm
WE textures/simonkraft/wet_sponge.xpm
EA textures/simonkraft/wet_sponge.xpm

F 164,169,20
C 153, 0, 20

111111111111111111111
101011111111111010101
100010000000000010001
101010111011111111101   
1N1000001000000000001
111111111111111111111

    

